****************
*P     *       *
*      *    M  *
*      *       *
*        ***   *
*    **        *
*    M         *
*              *
*       G      *
****************